##############################
#     #     # #    # #   # # #
## ##   ## #    ##   # #     #
#    # #   # # #   ##  ##### #
# ## ##  ##  #  ###   #    # #
#  #   #   #  #   # ##  # #  #
# #  # ####  # ## # #  #   # #
##S# #    # #   # #   #  # # #
#  ##  ##     # #  # #  ###  #
# #   ## # ##  #  ##  #  #  ##
# # # #   #  # # #  #  ##  ###
#  ###  #   #  #   #  #   # ##
##  #  # ##  #  ##  # # ##   #
###   #    #  #   # # #    # #
## ###  ##  #  ## #    # ### #
#     #   #  #   #  # #  #   #
# ###### # #  ## # #   ##  # #
# #   ## #  #     # ###   ## #
#   #      #  # #       ##  E#
##############################
